111111
101111
101101
102101
111111