111111
100011
100001
102001
111111