000000110
001111110
001101110
001101110
111111110